,Rank,NOC,Gold,Silver,Bronze,Total,Year,Host
0,1,United States,11,7,2,20,1896,False
1,2,Greece,10,18,19,47,1896,True
2,3,Germany,6,5,2,13,1896,False
3,4,France,5,4,2,11,1896,False
4,5,Great Britain,2,3,2,7,1896,False
5,6,Hungary,2,1,3,6,1896,False
6,7,Austria,2,1,2,5,1896,False
7,8,Australia,2,0,0,2,1896,False
8,9,Denmark,1,2,3,6,1896,False
9,10,Switzerland,1,2,0,3,1896,False
10,11,Mixed team,1,0,1,2,1896,False
11,1,France,27,39,37,103,1900,True
12,2,United States,19,14,15,48,1900,False
13,3,Great Britain,15,7,9,31,1900,False
14,4,Mixed team,8,5,6,19,1900,False
15,5,Belgium,6,7,4,17,1900,False
16,6,Switzerland,6,2,1,9,1900,False
17,7,Germany,4,3,2,9,1900,False
18,8,Italy,3,2,0,5,1900,False
19,9,Australia,2,0,3,5,1900,False
20,10,Denmark,1,3,2,6,1900,False
21,11,Hungary,1,2,2,5,1900,False
22,12,Cuba,1,1,0,2,1900,False
23,13,Canada,1,0,1,2,1900,False
24,14,Spain,1,0,0,1,1900,False
25,14,Luxembourg,1,0,0,1,1900,False
26,16,Austria,0,3,3,6,1900,False
27,17,Norway,0,2,3,5,1900,False
28,17,Netherlands,0,2,3,5,1900,False
29,19,India,0,2,0,2,1900,False
30,20,Bohemia,0,1,1,2,1900,False
31,21,Sweden,0,0,1,1,1900,False
32,1,United States,76,78,77,231,1904,True
33,2,Germany,4,5,6,15,1904,False
34,3,Canada,4,1,1,6,1904,False
35,4,Cuba,3,0,0,3,1904,False
36,5,Hungary,2,1,1,4,1904,False
37,5,Mixed team,2,1,1,4,1904,False
38,7,Norway,2,0,0,2,1904,False
39,8,Austria,1,1,1,3,1904,False
40,9,Great Britain,1,1,0,2,1904,False
41,10,Switzerland,1,0,2,3,1904,False
42,11,Greece,1,0,1,2,1904,False
43,12,Australia,0,3,1,4,1904,False
44,13,France,0,1,0,1,1904,False
45,1,Great Britain,56,51,39,146,1908,True
46,2,United States,23,12,12,47,1908,False
47,3,Sweden,8,6,11,25,1908,False
48,4,France,5,5,9,19,1908,False
49,5,Germany,3,5,5,13,1908,False
50,6,Hungary,3,4,2,9,1908,False
51,7,Canada,3,3,10,16,1908,False
52,8,Norway,2,3,3,8,1908,False
53,9,Italy,2,2,0,4,1908,False
54,10,Belgium,1,5,2,8,1908,False
55,11,Australasia,1,2,2,5,1908,False
56,12,Russian Empire,1,2,0,3,1908,False
57,13,Finland,1,1,3,5,1908,False
58,14,South Africa,1,1,0,2,1908,False
59,15,Greece,0,3,1,4,1908,False
60,16,Denmark,0,2,3,5,1908,False
61,17,Bohemia,0,0,2,2,1908,False
62,17,Netherlands,0,0,2,2,1908,False
63,19,Austria,0,0,1,1,1908,False
64,1,United States,26,19,19,64,1912,False
65,2,Sweden,23,25,17,65,1912,True
66,3,Great Britain,10,15,16,41,1912,False
67,4,Finland,9,8,9,26,1912,False
68,5,France,7,4,3,14,1912,False
69,6,Germany,5,13,7,25,1912,False
70,7,South Africa,4,2,0,6,1912,False
71,8,Norway,3,2,5,10,1912,False
72,9,Canada,3,2,3,8,1912,False
73,9,Hungary,3,2,3,8,1912,False
74,11,Italy,3,1,2,6,1912,False
75,12,Australasia,2,2,3,7,1912,False
76,13,Belgium,2,1,3,6,1912,False
77,14,Denmark,1,6,5,12,1912,False
78,15,Greece,1,0,1,2,1912,False
79,16,Russian Empire,0,2,3,5,1912,False
80,17,Austria,0,2,2,4,1912,False
81,18,Netherlands,0,0,3,3,1912,False
82,1,United States,41,27,27,95,1920,False
83,2,Sweden,19,20,25,64,1920,False
84,3,Finland,15,10,9,34,1920,False
85,4,Great Britain,14,15,13,42,1920,False
86,5,Belgium,14,11,11,36,1920,True
87,6,Norway,13,9,9,31,1920,False
88,7,Italy,13,5,5,23,1920,False
89,8,France,9,19,13,41,1920,False
90,9,Netherlands,4,2,5,11,1920,False
91,10,Denmark,3,9,1,13,1920,False
92,11,South Africa,3,4,3,10,1920,False
93,12,Canada,3,3,3,9,1920,False
94,13,Switzerland,2,2,7,11,1920,False
95,14,Estonia,1,2,0,3,1920,False
96,15,Brazil,1,1,1,3,1920,False
97,16,Australia,0,2,1,3,1920,False
98,17,Japan,0,2,0,2,1920,False
99,17,Spain,0,2,0,2,1920,False
100,19,Greece,0,1,0,1,1920,False
101,19,Luxembourg,0,1,0,1,1920,False
102,21,Czechoslovakia,0,0,2,2,1920,False
103,22,New Zealand,0,0,1,1,1920,False
104,1,United States,45,27,27,99,1924,False
105,2,Finland,14,13,10,37,1924,False
106,3,France,13,15,10,38,1924,True
107,4,Great Britain,9,13,12,34,1924,False
108,5,Italy,8,3,5,16,1924,False
109,6,Switzerland,7,8,10,25,1924,False
110,7,Norway,5,2,3,10,1924,False
111,8,Sweden,4,13,12,29,1924,False
112,9,Netherlands,4,1,5,10,1924,False
113,10,Belgium,3,7,3,13,1924,False
114,11,Australia,3,1,2,6,1924,False
115,12,Denmark,2,5,2,9,1924,False
116,13,Hungary,2,3,4,9,1924,False
117,14,Yugoslavia,2,0,0,2,1924,False
118,15,Czechoslovakia,1,4,5,10,1924,False
119,16,Argentina,1,3,2,6,1924,False
120,17,Estonia,1,1,4,6,1924,False
121,18,South Africa,1,1,1,3,1924,False
122,19,Uruguay,1,0,0,1,1924,False
123,20,Austria,0,3,1,4,1924,False
124,20,Canada,0,3,1,4,1924,False
125,22,Poland,0,1,1,2,1924,False
126,23,Haiti,0,0,1,1,1924,False
127,23,Japan,0,0,1,1,1924,False
128,23,New Zealand,0,0,1,1,1924,False
129,23,Portugal,0,0,1,1,1924,False
130,23,Romania,0,0,1,1,1924,False
131,1,United States,22,18,16,56,1928,False
132,2,Germany,10,7,14,31,1928,False
133,3,Finland,8,8,9,25,1928,False
134,4,Sweden,7,6,12,25,1928,False
135,5,Italy,7,5,7,19,1928,False
136,6,Switzerland,7,4,4,15,1928,False
137,7,France,6,10,5,21,1928,False
138,8,Netherlands,6,9,4,19,1928,True
139,9,Hungary,4,5,0,9,1928,False
140,10,Canada,4,4,7,15,1928,False
141,11,Great Britain,3,10,7,20,1928,False
142,12,Argentina,3,3,1,7,1928,False
143,13,Denmark,3,1,2,6,1928,False
144,14,Czechoslovakia,2,5,2,9,1928,False
145,15,Japan,2,2,1,5,1928,False
146,16,Estonia,2,1,2,5,1928,False
147,17,Egypt,2,1,1,4,1928,False
148,18,Austria,2,0,1,3,1928,False
149,19,Australia,1,2,1,4,1928,False
150,19,Norway,1,2,1,4,1928,False
151,21,Poland,1,1,3,5,1928,False
152,21,Yugoslavia,1,1,3,5,1928,False
153,23,South Africa,1,0,2,3,1928,False
154,24,India,1,0,0,1,1928,False
155,24,Ireland,1,0,0,1,1928,False
156,24,New Zealand,1,0,0,1,1928,False
157,24,Spain,1,0,0,1,1928,False
158,24,Uruguay,1,0,0,1,1928,False
159,29,Belgium,0,1,2,3,1928,False
160,30,Chile,0,1,0,1,1928,False
161,30,Haiti,0,1,0,1,1928,False
162,32,Philippines,0,0,1,1,1928,False
163,32,Portugal,0,0,1,1,1928,False
164,1,United States,44,36,30,110,1932,True
165,2,Italy,12,12,12,36,1932,False
166,3,France,11,5,4,20,1932,False
167,4,Sweden,10,5,9,24,1932,False
168,5,Japan,7,7,4,18,1932,False
169,6,Hungary,6,5,5,16,1932,False
170,7,Germany,5,12,7,24,1932,False
171,8,Finland,5,8,12,25,1932,False
172,9,Great Britain,5,7,5,17,1932,False
173,10,Poland,3,2,4,9,1932,False
174,11,Australia,3,1,1,5,1932,False
175,12,Argentina,3,1,0,4,1932,False
176,13,Canada,2,5,9,16,1932,False
177,14,Netherlands,2,5,1,8,1932,False
178,15,South Africa,2,0,3,5,1932,False
179,16,Ireland,2,0,0,2,1932,False
180,17,Czechoslovakia,1,3,2,6,1932,False
181,18,Austria,1,1,3,5,1932,False
182,19,India,1,0,0,1,1932,False
183,20,Denmark,0,5,3,8,1932,False
184,21,Mexico,0,2,0,2,1932,False
185,22,Latvia,0,1,0,1,1932,False
186,22,New Zealand,0,1,0,1,1932,False
187,22,Switzerland,0,1,0,1,1932,False
188,25,Philippines,0,0,3,3,1932,False
189,26,Belgium,0,0,1,1,1932,False
190,26,Spain,0,0,1,1,1932,False
191,26,Uruguay,0,0,1,1,1932,False
192,1,Germany,38,31,32,101,1936,True
193,2,United States,24,21,12,57,1936,False
194,3,Hungary,10,1,5,16,1936,False
195,4,Italy,9,13,5,27,1936,False
196,5,Finland,8,6,6,20,1936,False
197,6,France,7,6,6,19,1936,False
198,7,Sweden,6,5,10,21,1936,False
199,8,Japan,6,4,10,20,1936,False
200,9,Netherlands,6,4,7,17,1936,False
201,10,Austria,5,7,5,17,1936,False
202,11,Switzerland,4,9,5,18,1936,False
203,12,Great Britain,4,7,3,14,1936,False
204,13,Czechoslovakia,3,5,1,9,1936,False
205,14,Argentina,2,2,3,7,1936,False
206,14,Estonia,2,2,3,7,1936,False
207,16,Egypt,2,1,2,5,1936,False
208,17,Canada,1,3,5,9,1936,False
209,18,Norway,1,3,2,6,1936,False
210,19,Turkey,1,0,1,2,1936,False
211,20,India,1,0,0,1,1936,False
212,20,New Zealand,1,0,0,1,1936,False
213,22,Poland,0,4,5,9,1936,False
214,23,Denmark,0,2,3,5,1936,False
215,24,Latvia,0,1,1,2,1936,False
216,25,Romania,0,1,0,1,1936,False
217,25,South Africa,0,1,0,1,1936,False
218,25,Yugoslavia,0,1,0,1,1936,False
219,28,Belgium,0,0,3,3,1936,False
220,28,Mexico,0,0,3,3,1936,False
221,30,Australia,0,0,1,1,1936,False
222,30,Philippines,0,0,1,1,1936,False
223,30,Portugal,0,0,1,1,1936,False
224,1,United States,38,27,19,84,1948,False
225,2,Sweden,16,11,17,44,1948,False
226,3,France,10,6,13,29,1948,False
227,4,Hungary,10,5,12,27,1948,False
228,5,Italy,8,11,8,27,1948,False
229,6,Finland,8,7,5,20,1948,False
230,7,Turkey,6,4,2,12,1948,False
231,8,Czechoslovakia,6,2,3,11,1948,False
232,9,Switzerland,5,10,5,20,1948,False
233,10,Denmark,5,7,8,20,1948,False
234,11,Netherlands,5,2,9,16,1948,False
235,12,Great Britain,3,14,6,23,1948,True
236,13,Argentina,3,3,1,7,1948,False
237,14,Australia,2,6,5,13,1948,False
238,15,Belgium,2,2,3,7,1948,False
239,16,Egypt,2,2,1,5,1948,False
240,17,Mexico,2,1,2,5,1948,False
241,18,South Africa,2,1,1,4,1948,False
242,19,Norway,1,3,3,7,1948,False
243,20,Jamaica,1,2,0,3,1948,False
244,21,Austria,1,0,3,4,1948,False
245,22,India,1,0,0,1,1948,False
246,22,Peru,1,0,0,1,1948,False
247,24,Yugoslavia,0,2,0,2,1948,False
248,25,Canada,0,1,2,3,1948,False
249,26,Portugal,0,1,1,2,1948,False
250,26,Uruguay,0,1,1,2,1948,False
251,28,Ceylon,0,1,0,1,1948,False
252,28,Cuba,0,1,0,1,1948,False
253,28,Spain,0,1,0,1,1948,False
254,28,Trinidad and Tobago,0,1,0,1,1948,False
255,32,Panama,0,0,2,2,1948,False
256,32,South Korea,0,0,2,2,1948,False
257,34,Brazil,0,0,1,1,1948,False
258,34,Iran,0,0,1,1,1948,False
259,34,Poland,0,0,1,1,1948,False
260,34,Puerto Rico,0,0,1,1,1948,False
261,1,United States,40,19,17,76,1952,False
262,2,Soviet Union,22,30,19,71,1952,False
263,3,Hungary,16,10,16,42,1952,False
264,4,Sweden,12,13,10,35,1952,False
265,5,Italy,8,9,4,21,1952,False
266,6,Czechoslovakia,7,3,3,13,1952,False
267,7,France,6,6,6,18,1952,False
268,8,Finland,6,3,13,22,1952,True
269,9,Australia,6,2,3,11,1952,False
270,10,Norway,3,2,0,5,1952,False
271,11,Switzerland,2,6,6,14,1952,False
272,12,South Africa,2,4,4,10,1952,False
273,13,Jamaica,2,3,0,5,1952,False
274,14,Belgium,2,2,0,4,1952,False
275,15,Denmark,2,1,3,6,1952,False
276,16,Turkey,2,0,1,3,1952,False
277,17,Japan,1,6,2,9,1952,False
278,18,Great Britain,1,2,8,11,1952,False
279,19,Argentina,1,2,2,5,1952,False
280,20,Poland,1,2,1,4,1952,False
281,21,Canada,1,2,0,3,1952,False
282,21,Yugoslavia,1,2,0,3,1952,False
283,23,Romania,1,1,2,4,1952,False
284,24,Brazil,1,0,2,3,1952,False
285,24,New Zealand,1,0,2,3,1952,False
286,26,India,1,0,1,2,1952,False
287,27,Luxembourg,1,0,0,1,1952,False
288,28,Germany,0,7,17,24,1952,False
289,29,Netherlands,0,5,0,5,1952,False
290,30,Iran,0,3,4,7,1952,False
291,31,Chile,0,2,0,2,1952,False
292,32,Austria,0,1,1,2,1952,False
293,32,Lebanon,0,1,1,2,1952,False
294,34,Ireland,0,1,0,1,1952,False
295,34,Mexico,0,1,0,1,1952,False
296,34,Spain,0,1,0,1,1952,False
297,37,South Korea,0,0,2,2,1952,False
298,37,Trinidad and Tobago,0,0,2,2,1952,False
299,37,Uruguay,0,0,2,2,1952,False
300,40,Bulgaria,0,0,1,1,1952,False
301,40,Egypt,0,0,1,1,1952,False
302,40,Portugal,0,0,1,1,1952,False
303,40,Venezuela,0,0,1,1,1952,False
304,1,Soviet Union,37,29,32,98,1956,False
305,2,United States,32,25,17,74,1956,False
306,3,Australia,13,8,14,35,1956,True
307,4,Hungary,9,10,7,26,1956,False
308,5,Italy,8,8,9,25,1956,False
309,6,Sweden,8,5,6,19,1956,False
310,7,United Team of Germany,6,13,7,26,1956,False
311,8,Great Britain,6,7,11,24,1956,False
312,9,Romania,5,3,5,13,1956,False
313,10,Japan,4,10,5,19,1956,False
314,11,France,4,4,6,14,1956,False
315,12,Turkey,3,2,2,7,1956,False
316,13,Finland,3,1,11,15,1956,False
317,14,Iran,2,2,1,5,1956,False
318,15,Canada,2,1,3,6,1956,False
319,16,New Zealand,2,0,0,2,1956,False
320,17,Poland,1,4,4,9,1956,False
321,18,Czechoslovakia,1,4,1,6,1956,False
322,19,Bulgaria,1,3,1,5,1956,False
323,20,Denmark,1,2,1,4,1956,False
324,21,Ireland,1,1,3,5,1956,False
325,22,Norway,1,0,2,3,1956,False
326,23,Mexico,1,0,1,2,1956,False
327,24,Brazil,1,0,0,1,1956,False
328,24,India,1,0,0,1,1956,False
329,26,Yugoslavia,0,3,0,3,1956,False
330,27,Chile,0,2,2,4,1956,False
331,28,Belgium,0,2,0,2,1956,False
332,29,Argentina,0,1,1,2,1956,False
333,29,South Korea,0,1,1,2,1956,False
334,31,Iceland,0,1,0,1,1956,False
335,31,Pakistan,0,1,0,1,1956,False
336,33,South Africa,0,0,4,4,1956,False
337,34,Austria,0,0,2,2,1956,False
338,35,Bahamas,0,0,1,1,1956,False
339,35,Greece,0,0,1,1,1956,False
340,35,Switzerland,0,0,1,1,1956,False
341,35,Uruguay,0,0,1,1,1956,False
342,1,Soviet Union,43,29,31,103,1960,False
343,2,United States,34,21,16,71,1960,False
344,3,Italy,13,10,13,36,1960,True
345,4,United Team of Germany,12,19,11,42,1960,False
346,5,Australia,8,8,6,22,1960,False
347,6,Turkey,7,2,0,9,1960,False
348,7,Hungary,6,8,7,21,1960,False
349,8,Japan,4,7,7,18,1960,False
350,9,Poland,4,6,11,21,1960,False
351,10,Czechoslovakia,3,2,3,8,1960,False
352,11,Romania,3,1,6,10,1960,False
353,12,Great Britain,2,6,12,20,1960,False
354,13,Denmark,2,3,1,6,1960,False
355,14,New Zealand,2,0,1,3,1960,False
356,15,Bulgaria,1,3,3,7,1960,False
357,16,Sweden,1,2,3,6,1960,False
358,17,Finland,1,1,3,5,1960,False
359,18,Austria,1,1,0,2,1960,False
360,18,Yugoslavia,1,1,0,2,1960,False
361,20,Pakistan,1,0,1,2,1960,False
362,21,Ethiopia,1,0,0,1,1960,False
363,21,Greece,1,0,0,1,1960,False
364,21,Norway,1,0,0,1,1960,False
365,24,Switzerland,0,3,3,6,1960,False
366,25,France,0,2,3,5,1960,False
367,26,Belgium,0,2,2,4,1960,False
368,27,Iran,0,1,3,4,1960,False
369,28,Netherlands,0,1,2,3,1960,False
370,28,South Africa,0,1,2,3,1960,False
371,30,Argentina,0,1,1,2,1960,False
372,30,Egypt,0,1,1,2,1960,False
373,32,Canada,0,1,0,1,1960,False
374,32,Formosa,0,1,0,1,1960,False
375,32,Ghana,0,1,0,1,1960,False
376,32,India,0,1,0,1,1960,False
377,32,Morocco,0,1,0,1,1960,False
378,32,Portugal,0,1,0,1,1960,False
379,32,Singapore,0,1,0,1,1960,False
380,39,Brazil,0,0,2,2,1960,False
381,39,British West Indies,0,0,2,2,1960,False
382,41,Iraq,0,0,1,1,1960,False
383,41,Mexico,0,0,1,1,1960,False
384,41,Spain,0,0,1,1,1960,False
385,41,Venezuela,0,0,1,1,1960,False
386,1,United States,36,26,28,90,1964,False
387,2,Soviet Union,30,31,35,96,1964,False
388,3,Japan,16,5,8,29,1964,True
389,4,United Team of Germany,10,22,18,50,1964,False
390,5,Italy,10,10,7,27,1964,False
391,6,Hungary,10,7,5,22,1964,False
392,7,Poland,7,6,10,23,1964,False
393,8,Australia,6,2,10,18,1964,False
394,9,Czechoslovakia,5,6,3,14,1964,False
395,10,Great Britain,4,12,2,18,1964,False
396,11,Bulgaria,3,5,2,10,1964,False
397,12,Finland,3,0,2,5,1964,False
398,12,New Zealand,3,0,2,5,1964,False
399,14,Romania,2,4,6,12,1964,False
400,15,Netherlands,2,4,4,10,1964,False
401,16,Turkey,2,3,1,6,1964,False
402,17,Sweden,2,2,4,8,1964,False
403,18,Denmark,2,1,3,6,1964,False
404,19,Yugoslavia,2,1,2,5,1964,False
405,20,Belgium,2,0,1,3,1964,False
406,21,France,1,8,6,15,1964,False
407,22,Canada,1,2,1,4,1964,False
408,22,Switzerland,1,2,1,4,1964,False
409,24,Bahamas,1,0,0,1,1964,False
410,24,Ethiopia,1,0,0,1,1964,False
411,24,India,1,0,0,1,1964,False
412,27,South Korea,0,2,1,3,1964,False
413,28,Trinidad and Tobago,0,1,2,3,1964,False
414,29,Tunisia,0,1,1,2,1964,False
415,30,Argentina,0,1,0,1,1964,False
416,30,Cuba,0,1,0,1,1964,False
417,30,Pakistan,0,1,0,1,1964,False
418,30,Philippines,0,1,0,1,1964,False
419,34,Iran,0,0,2,2,1964,False
420,35,Brazil,0,0,1,1,1964,False
421,35,Ghana,0,0,1,1,1964,False
422,35,Ireland,0,0,1,1,1964,False
423,35,Kenya,0,0,1,1,1964,False
424,35,Mexico,0,0,1,1,1964,False
425,35,Nigeria,0,0,1,1,1964,False
426,35,Uruguay,0,0,1,1,1964,False
427,1,United States,45,28,34,107,1968,False
428,2,Soviet Union,29,32,30,91,1968,False
429,3,Japan,11,7,7,25,1968,False
430,4,Hungary,10,10,12,32,1968,False
431,5,East Germany,9,9,7,25,1968,False
432,6,France,7,3,5,15,1968,False
433,7,Czechoslovakia,7,2,4,13,1968,False
434,8,West Germany,5,11,10,26,1968,False
435,9,Australia,5,7,5,17,1968,False
436,10,Great Britain,5,5,3,13,1968,False
437,11,Poland,5,2,11,18,1968,False
438,12,Romania,4,6,5,15,1968,False
439,13,Italy,3,4,9,16,1968,False
440,14,Kenya,3,4,2,9,1968,False
441,15,Mexico,3,3,3,9,1968,True
442,16,Yugoslavia,3,3,2,8,1968,False
443,17,Netherlands,3,3,1,7,1968,False
444,18,Bulgaria,2,4,3,9,1968,False
445,19,Iran,2,1,2,5,1968,False
446,20,Sweden,2,1,1,4,1968,False
447,21,Turkey,2,0,0,2,1968,False
448,22,Denmark,1,4,3,8,1968,False
449,23,Canada,1,3,1,5,1968,False
450,24,Finland,1,2,1,4,1968,False
451,25,Ethiopia,1,1,0,2,1968,False
452,25,Norway,1,1,0,2,1968,False
453,27,New Zealand,1,0,2,3,1968,False
454,28,Tunisia,1,0,1,2,1968,False
455,29,Pakistan,1,0,0,1,1968,False
456,29,Venezuela,1,0,0,1,1968,False
457,31,Cuba,0,4,0,4,1968,False
458,32,Austria,0,2,2,4,1968,False
459,33,Switzerland,0,1,4,5,1968,False
460,34,Mongolia,0,1,3,4,1968,False
461,35,Brazil,0,1,2,3,1968,False
462,36,Belgium,0,1,1,2,1968,False
463,36,South Korea,0,1,1,2,1968,False
464,36,Uganda,0,1,1,2,1968,False
465,39,Cameroon,0,1,0,1,1968,False
466,39,Jamaica,0,1,0,1,1968,False
467,41,Argentina,0,0,2,2,1968,False
468,42,Greece,0,0,1,1,1968,False
469,42,India,0,0,1,1,1968,False
470,42,Taiwan,0,0,1,1,1968,False
471,1,Soviet Union,50,27,22,99,1972,False
472,2,United States,33,31,30,94,1972,False
473,3,East Germany,20,23,23,66,1972,False
474,4,West Germany,13,11,16,40,1972,True
475,5,Japan,13,8,8,29,1972,False
476,6,Australia,8,7,2,17,1972,False
477,7,Poland,7,5,9,21,1972,False
478,8,Hungary,6,13,16,35,1972,False
479,9,Bulgaria,6,10,5,21,1972,False
480,10,Italy,5,3,10,18,1972,False
481,11,Sweden,4,6,6,16,1972,False
482,12,Great Britain,4,5,9,18,1972,False
483,13,Romania,3,6,7,16,1972,False
484,14,Cuba,3,1,4,8,1972,False
485,14,Finland,3,1,4,8,1972,False
486,16,Netherlands,3,1,1,5,1972,False
487,17,France,2,4,7,13,1972,False
488,18,Czechoslovakia,2,4,2,8,1972,False
489,19,Kenya,2,3,4,9,1972,False
490,20,Yugoslavia,2,1,2,5,1972,False
491,21,Norway,2,1,1,4,1972,False
492,22,North Korea,1,1,3,5,1972,False
493,23,New Zealand,1,1,1,3,1972,False
494,24,Uganda,1,1,0,2,1972,False
495,25,Denmark,1,0,0,1,1972,False
496,26,Switzerland,0,3,0,3,1972,False
497,27,Canada,0,2,3,5,1972,False
498,28,Iran,0,2,1,3,1972,False
499,29,Belgium,0,2,0,2,1972,False
500,29,Greece,0,2,0,2,1972,False
501,31,Austria,0,1,2,3,1972,False
502,31,Colombia,0,1,2,3,1972,False
503,33,Argentina,0,1,0,1,1972,False
504,33,Lebanon,0,1,0,1,1972,False
505,33,Mexico,0,1,0,1,1972,False
506,33,Mongolia,0,1,0,1,1972,False
507,33,Pakistan,0,1,0,1,1972,False
508,33,South Korea,0,1,0,1,1972,False
509,33,Tunisia,0,1,0,1,1972,False
510,33,Turkey,0,1,0,1,1972,False
511,41,Brazil,0,0,2,2,1972,False
512,41,Ethiopia,0,0,2,2,1972,False
513,43,Ghana,0,0,1,1,1972,False
514,43,India,0,0,1,1,1972,False
515,43,Jamaica,0,0,1,1,1972,False
516,43,Niger,0,0,1,1,1972,False
517,43,Nigeria,0,0,1,1,1972,False
518,43,Spain,0,0,1,1,1972,False
519,1,Soviet Union,49,41,35,125,1976,False
520,2,East Germany,40,25,25,90,1976,False
521,3,United States,34,35,25,94,1976,False
522,4,West Germany,10,12,17,39,1976,False
523,5,Japan,9,6,10,25,1976,False
524,6,Poland,7,6,13,26,1976,False
525,7,Bulgaria,6,9,7,22,1976,False
526,8,Cuba,6,4,3,13,1976,False
527,9,Romania,4,9,14,27,1976,False
528,10,Hungary,4,5,13,22,1976,False
529,11,Finland,4,2,0,6,1976,False
530,12,Sweden,4,1,0,5,1976,False
531,13,Great Britain,3,5,5,13,1976,False
532,14,Italy,2,7,4,13,1976,False
533,15,France,2,3,4,9,1976,False
534,16,Yugoslavia,2,3,3,8,1976,False
535,17,Czechoslovakia,2,2,4,8,1976,False
536,18,New Zealand,2,1,1,4,1976,False
537,19,South Korea,1,1,4,6,1976,False
538,20,Switzerland,1,1,2,4,1976,False
539,21,Jamaica,1,1,0,2,1976,False
540,21,North Korea,1,1,0,2,1976,False
541,21,Norway,1,1,0,2,1976,False
542,24,Denmark,1,0,2,3,1976,False
543,25,Mexico,1,0,1,2,1976,False
544,26,Trinidad and Tobago,1,0,0,1,1976,False
545,27,Canada,0,5,6,11,1976,True
546,28,Belgium,0,3,3,6,1976,False
547,29,Netherlands,0,2,3,5,1976,False
548,30,Portugal,0,2,0,2,1976,False
549,30,Spain,0,2,0,2,1976,False
550,32,Australia,0,1,4,5,1976,False
551,33,Iran,0,1,1,2,1976,False
552,34,Mongolia,0,1,0,1,1976,False
553,34,Venezuela,0,1,0,1,1976,False
554,36,Brazil,0,0,2,2,1976,False
555,37,Austria,0,0,1,1,1976,False
556,37,Bermuda,0,0,1,1,1976,False
557,37,Pakistan,0,0,1,1,1976,False
558,37,Puerto Rico,0,0,1,1,1976,False
559,37,Thailand,0,0,1,1,1976,False
560,1,Soviet Union,80,69,46,195,1980,True
561,2,East Germany,47,37,42,126,1980,False
562,3,Bulgaria,8,16,17,41,1980,False
563,4,Cuba,8,7,5,20,1980,False
564,5,Italy,8,3,4,15,1980,False
565,6,Hungary,7,10,15,32,1980,False
566,7,Romania,6,6,13,25,1980,False
567,8,France,6,5,3,14,1980,False
568,9,Great Britain,5,7,9,21,1980,False
569,10,Poland,3,14,15,32,1980,False
570,11,Sweden,3,3,6,12,1980,False
571,12,Finland,3,1,4,8,1980,False
572,13,Czechoslovakia,2,3,9,14,1980,False
573,14,Yugoslavia,2,3,4,9,1980,False
574,15,Australia,2,2,5,9,1980,False
575,16,Denmark,2,1,2,5,1980,False
576,17,Brazil,2,0,2,4,1980,False
577,17,Ethiopia,2,0,2,4,1980,False
578,19,Switzerland,2,0,0,2,1980,False
579,20,Spain,1,3,2,6,1980,False
580,21,Austria,1,2,1,4,1980,False
581,22,Greece,1,0,2,3,1980,False
582,23,Belgium,1,0,0,1,1980,False
583,23,India,1,0,0,1,1980,False
584,23,Zimbabwe,1,0,0,1,1980,False
585,26,North Korea,0,3,2,5,1980,False
586,27,Mongolia,0,2,2,4,1980,False
587,28,Tanzania,0,2,0,2,1980,False
588,29,Mexico,0,1,3,4,1980,False
589,30,Netherlands,0,1,2,3,1980,False
590,31,Ireland,0,1,1,2,1980,False
591,32,Uganda,0,1,0,1,1980,False
592,32,Venezuela,0,1,0,1,1980,False
593,34,Jamaica,0,0,3,3,1980,False
594,35,Guyana,0,0,1,1,1980,False
595,35,Lebanon,0,0,1,1,1980,False
596,1,United States,83,61,30,174,1984,True
597,2,Romania,20,16,17,53,1984,False
598,3,West Germany,17,19,23,59,1984,False
599,4,China,15,8,9,32,1984,False
600,5,Italy,14,6,12,32,1984,False
601,6,Canada,10,18,16,44,1984,False
602,7,Japan,10,8,14,32,1984,False
603,8,New Zealand,8,1,2,11,1984,False
604,9,Yugoslavia,7,4,7,18,1984,False
605,10,South Korea,6,6,7,19,1984,False
606,11,Great Britain,5,11,21,37,1984,False
607,12,France,5,7,16,28,1984,False
608,13,Netherlands,5,2,6,13,1984,False
609,14,Australia,4,8,12,24,1984,False
610,15,Finland,4,2,6,12,1984,False
611,16,Sweden,2,11,6,19,1984,False
612,17,Mexico,2,3,1,6,1984,False
613,18,Morocco,2,0,0,2,1984,False
614,19,Brazil,1,5,2,8,1984,False
615,20,Spain,1,2,2,5,1984,False
616,21,Belgium,1,1,2,4,1984,False
617,22,Austria,1,1,1,3,1984,False
618,23,Kenya,1,0,2,3,1984,False
619,23,Portugal,1,0,2,3,1984,False
620,25,Pakistan,1,0,0,1,1984,False
621,26,Switzerland,0,4,4,8,1984,False
622,27,Denmark,0,3,3,6,1984,False
623,28,Jamaica,0,1,2,3,1984,False
624,28,Norway,0,1,2,3,1984,False
625,30,Greece,0,1,1,2,1984,False
626,30,Nigeria,0,1,1,2,1984,False
627,30,Puerto Rico,0,1,1,2,1984,False
628,33,Colombia,0,1,0,1,1984,False
629,33,Egypt,0,1,0,1,1984,False
630,33,Ireland,0,1,0,1,1984,False
631,33,Ivory Coast,0,1,0,1,1984,False
632,33,Peru,0,1,0,1,1984,False
633,33,Syria,0,1,0,1,1984,False
634,33,Thailand,0,1,0,1,1984,False
635,40,Turkey,0,0,3,3,1984,False
636,40,Venezuela,0,0,3,3,1984,False
637,42,Algeria,0,0,2,2,1984,False
638,43,Cameroon,0,0,1,1,1984,False
639,43,Chinese Taipei,0,0,1,1,1984,False
640,43,Dominican Republic,0,0,1,1,1984,False
641,43,Iceland,0,0,1,1,1984,False
642,43,Zambia,0,0,1,1,1984,False
643,1,Soviet Union,55,31,46,132,1988,False
644,2,East Germany,37,35,30,102,1988,False
645,3,United States,36,31,27,94,1988,False
646,4,South Korea,12,10,11,33,1988,True
647,5,West Germany,11,14,15,40,1988,False
648,6,Hungary,11,6,6,23,1988,False
649,7,Bulgaria,10,12,13,35,1988,False
650,8,Romania,7,11,6,24,1988,False
651,9,France,6,4,6,16,1988,False
652,10,Italy,6,4,4,14,1988,False
653,11,China,5,11,12,28,1988,False
654,12,Great Britain,5,10,9,24,1988,False
655,13,Kenya,5,2,2,9,1988,False
656,14,Japan,4,3,7,14,1988,False
657,15,Australia,3,6,5,14,1988,False
658,16,Yugoslavia,3,4,5,12,1988,False
659,17,Czechoslovakia,3,3,2,8,1988,False
660,18,New Zealand,3,2,8,13,1988,False
661,19,Canada,3,2,5,10,1988,False
662,20,Poland,2,5,9,16,1988,False
663,21,Norway,2,3,0,5,1988,False
664,22,Netherlands,2,2,5,9,1988,False
665,23,Denmark,2,1,1,4,1988,False
666,24,Brazil,1,2,3,6,1988,False
667,25,Finland,1,1,2,4,1988,False
668,25,Spain,1,1,2,4,1988,False
669,27,Turkey,1,1,0,2,1988,False
670,28,Morocco,1,0,2,3,1988,False
671,29,Austria,1,0,0,1,1988,False
672,29,Portugal,1,0,0,1,1988,False
673,29,Suriname,1,0,0,1,1988,False
674,32,Sweden,0,4,7,11,1988,False
675,33,Switzerland,0,2,2,4,1988,False
676,34,Jamaica,0,2,0,2,1988,False
677,35,Argentina,0,1,1,2,1988,False
678,36,Chile,0,1,0,1,1988,False
679,36,Costa Rica,0,1,0,1,1988,False
680,36,Indonesia,0,1,0,1,1988,False
681,36,Iran,0,1,0,1,1988,False
682,36,Netherlands Antilles,0,1,0,1,1988,False
683,36,Peru,0,1,0,1,1988,False
684,36,Senegal,0,1,0,1,1988,False
685,36,Virgin Islands,0,1,0,1,1988,False
686,44,Belgium,0,0,2,2,1988,False
687,44,Mexico,0,0,2,2,1988,False
688,46,Colombia,0,0,1,1,1988,False
689,46,Djibouti,0,0,1,1,1988,False
690,46,Greece,0,0,1,1,1988,False
691,46,Mongolia,0,0,1,1,1988,False
692,46,Pakistan,0,0,1,1,1988,False
693,46,Philippines,0,0,1,1,1988,False
694,46,Thailand,0,0,1,1,1988,False
695,1,Unified Team,45,38,29,112,1992,False
696,2,United States,37,34,37,108,1992,False
697,3,Germany,33,21,28,82,1992,False
698,4,China,16,22,16,54,1992,False
699,5,Cuba,14,6,11,31,1992,False
700,6,Spain,13,7,2,22,1992,True
701,7,South Korea,12,5,12,29,1992,False
702,8,Hungary,11,12,7,30,1992,False
703,9,France,8,5,16,29,1992,False
704,10,Australia,7,9,11,27,1992,False
705,11,Canada,7,4,7,18,1992,False
706,12,Italy,6,5,8,19,1992,False
707,13,Great Britain,5,3,12,20,1992,False
708,14,Romania,4,6,8,18,1992,False
709,15,Czechoslovakia,4,2,1,7,1992,False
710,16,North Korea,4,0,5,9,1992,False
711,17,Japan,3,8,11,22,1992,False
712,18,Bulgaria,3,7,6,16,1992,False
713,19,Poland,3,6,10,19,1992,False
714,20,Netherlands,2,6,7,15,1992,False
715,21,Kenya,2,4,2,8,1992,False
716,22,Norway,2,4,1,7,1992,False
717,23,Turkey,2,2,2,6,1992,False
718,24,Indonesia,2,2,1,5,1992,False
719,25,Brazil,2,1,0,3,1992,False
720,26,Greece,2,0,0,2,1992,False
721,27,Sweden,1,7,4,12,1992,False
722,28,New Zealand,1,4,5,10,1992,False
723,29,Finland,1,2,2,5,1992,False
724,30,Denmark,1,1,4,6,1992,False
725,31,Morocco,1,1,1,3,1992,False
726,32,Ireland,1,1,0,2,1992,False
727,33,Ethiopia,1,0,2,3,1992,False
728,34,Algeria,1,0,1,2,1992,False
729,34,Estonia,1,0,1,2,1992,False
730,34,Lithuania,1,0,1,2,1992,False
731,37,Switzerland,1,0,0,1,1992,False
732,38,Jamaica,0,3,1,4,1992,False
733,38,Nigeria,0,3,1,4,1992,False
734,40,Latvia,0,2,1,3,1992,False
735,41,Austria,0,2,0,2,1992,False
736,41,Namibia,0,2,0,2,1992,False
737,41,South Africa,0,2,0,2,1992,False
738,44,Belgium,0,1,2,3,1992,False
739,44,Croatia,0,1,2,3,1992,False
740,44,Independent Olympic Participants,0,1,2,3,1992,False
741,44,Iran,0,1,2,3,1992,False
742,48,Israel,0,1,1,2,1992,False
743,49,Chinese Taipei,0,1,0,1,1992,False
744,49,Mexico,0,1,0,1,1992,False
745,49,Peru,0,1,0,1,1992,False
746,52,Mongolia,0,0,2,2,1992,False
747,52,Slovenia,0,0,2,2,1992,False
748,54,Argentina,0,0,1,1,1992,False
749,54,Bahamas,0,0,1,1,1992,False
750,54,Colombia,0,0,1,1,1992,False
751,54,Ghana,0,0,1,1,1992,False
752,54,Malaysia,0,0,1,1,1992,False
753,54,Pakistan,0,0,1,1,1992,False
754,54,Philippines,0,0,1,1,1992,False
755,54,Puerto Rico,0,0,1,1,1992,False
756,54,Qatar,0,0,1,1,1992,False
757,54,Suriname,0,0,1,1,1992,False
758,54,Thailand,0,0,1,1,1992,False
759,1,United States,44,32,25,101,1996,True
760,2,Russia,26,21,16,63,1996,False
761,3,Germany,20,18,27,65,1996,False
762,4,China,16,22,12,50,1996,False
763,5,France,15,7,15,37,1996,False
764,6,Italy,13,10,12,35,1996,False
765,7,Australia,9,9,23,41,1996,False
766,8,Cuba,9,8,8,25,1996,False
767,9,Ukraine,9,2,12,23,1996,False
768,10,South Korea,7,15,5,27,1996,False
769,11,Poland,7,5,5,17,1996,False
770,12,Hungary,7,4,10,21,1996,False
771,13,Spain,5,6,6,17,1996,False
772,14,Romania,4,7,9,20,1996,False
773,15,Netherlands,4,5,10,19,1996,False
774,16,Greece,4,4,0,8,1996,False
775,17,Czech Republic,4,3,4,11,1996,False
776,18,Switzerland,4,3,0,7,1996,False
777,19,Denmark,4,1,1,6,1996,False
778,19,Turkey,4,1,1,6,1996,False
779,21,Canada,3,11,8,22,1996,False
780,22,Bulgaria,3,7,5,15,1996,False
781,23,Japan,3,6,5,14,1996,False
782,24,Kazakhstan,3,4,4,11,1996,False
783,25,Brazil,3,3,9,15,1996,False
784,26,New Zealand,3,2,1,6,1996,False
785,27,South Africa,3,1,1,5,1996,False
786,28,Ireland,3,0,1,4,1996,False
787,29,Sweden,2,4,2,8,1996,False
788,30,Norway,2,2,3,7,1996,False
789,31,Belgium,2,2,2,6,1996,False
790,32,Nigeria,2,1,3,6,1996,False
791,33,North Korea,2,1,2,5,1996,False
792,34,Algeria,2,0,1,3,1996,False
793,34,Ethiopia,2,0,1,3,1996,False
794,36,Great Britain,1,8,6,15,1996,False
795,37,Belarus,1,6,8,15,1996,False
796,38,Kenya,1,4,3,8,1996,False
797,39,Jamaica,1,3,2,6,1996,False
798,40,Finland,1,2,1,4,1996,False
799,41,FR Yugoslavia,1,1,2,4,1996,False
800,41,Indonesia,1,1,2,4,1996,False
801,43,Iran,1,1,1,3,1996,False
802,43,Slovakia,1,1,1,3,1996,False
803,45,Armenia,1,1,0,2,1996,False
804,45,Croatia,1,1,0,2,1996,False
805,47,Portugal,1,0,1,2,1996,False
806,47,Thailand,1,0,1,2,1996,False
807,49,Burundi,1,0,0,1,1996,False
808,49,Costa Rica,1,0,0,1,1996,False
809,49,Ecuador,1,0,0,1,1996,False
810,49,Hong Kong,1,0,0,1,1996,False
811,49,Syria,1,0,0,1,1996,False
812,54,Argentina,0,2,1,3,1996,False
813,55,Namibia,0,2,0,2,1996,False
814,55,Slovenia,0,2,0,2,1996,False
815,57,Austria,0,1,2,3,1996,False
816,58,Malaysia,0,1,1,2,1996,False
817,58,Moldova,0,1,1,2,1996,False
818,58,Uzbekistan,0,1,1,2,1996,False
819,61,Azerbaijan,0,1,0,1,1996,False
820,61,Bahamas,0,1,0,1,1996,False
821,61,Chinese Taipei,0,1,0,1,1996,False
822,61,Latvia,0,1,0,1,1996,False
823,61,Philippines,0,1,0,1,1996,False
824,61,Tonga,0,1,0,1,1996,False
825,61,Zambia,0,1,0,1,1996,False
826,68,Georgia,0,0,2,2,1996,False
827,68,Morocco,0,0,2,2,1996,False
828,68,Trinidad and Tobago,0,0,2,2,1996,False
829,71,India,0,0,1,1,1996,False
830,71,Israel,0,0,1,1,1996,False
831,71,Lithuania,0,0,1,1,1996,False
832,71,Mexico,0,0,1,1,1996,False
833,71,Mongolia,0,0,1,1,1996,False
834,71,Mozambique,0,0,1,1,1996,False
835,71,Puerto Rico,0,0,1,1,1996,False
836,71,Tunisia,0,0,1,1,1996,False
837,71,Uganda,0,0,1,1,1996,False
838,1,United States,37,24,32,93,2000,False
839,2,Russia,32,28,29,89,2000,False
840,3,China,28,16,14,58,2000,False
841,4,Australia,16,25,17,58,2000,True
842,5,Germany,13,17,26,56,2000,False
843,6,France,13,14,11,38,2000,False
844,7,Italy,13,8,13,34,2000,False
845,8,Netherlands,12,9,4,25,2000,False
846,9,Cuba,11,11,7,29,2000,False
847,10,Great Britain,11,10,7,28,2000,False
848,11,Romania,11,6,9,26,2000,False
849,12,South Korea,8,10,10,28,2000,False
850,13,Hungary,8,6,3,17,2000,False
851,14,Poland,6,5,3,14,2000,False
852,15,Japan,5,8,5,18,2000,False
853,16,Bulgaria,5,6,2,13,2000,False
854,17,Greece,4,6,3,13,2000,False
855,18,Sweden,4,5,3,12,2000,False
856,19,Norway,4,3,3,10,2000,False
857,20,Ethiopia,4,1,3,8,2000,False
858,21,Ukraine,3,10,10,23,2000,False
859,22,Kazakhstan,3,4,0,7,2000,False
860,23,Belarus,3,3,11,17,2000,False
861,24,Canada,3,3,8,14,2000,False
862,25,Spain,3,3,5,11,2000,False
863,26,Turkey,3,0,2,5,2000,False
864,27,Iran,3,0,1,4,2000,False
865,28,Czech Republic,2,3,3,8,2000,False
866,29,Kenya,2,3,2,7,2000,False
867,30,Denmark,2,3,1,6,2000,False
868,31,Finland,2,1,1,4,2000,False
869,32,Austria,2,1,0,3,2000,False
870,33,Lithuania,2,0,3,5,2000,False
871,34,Azerbaijan,2,0,1,3,2000,False
872,34,Bahamas,2,0,1,3,2000,False
873,36,Slovenia,2,0,0,2,2000,False
874,37,Switzerland,1,6,2,9,2000,False
875,38,Indonesia,1,3,2,6,2000,False
876,39,Slovakia,1,3,1,5,2000,False
877,40,Mexico,1,2,3,6,2000,False
878,41,Nigeria,1,2,0,3,2000,False
879,42,Algeria,1,1,3,5,2000,False
880,43,Uzbekistan,1,1,2,4,2000,False
881,44,FR Yugoslavia,1,1,1,3,2000,False
882,44,Latvia,1,1,1,3,2000,False
883,46,New Zealand,1,0,3,4,2000,False
884,47,Estonia,1,0,2,3,2000,False
885,47,Thailand,1,0,2,3,2000,False
886,49,Croatia,1,0,1,2,2000,False
887,50,Cameroon,1,0,0,1,2000,False
888,50,Colombia,1,0,0,1,2000,False
889,50,Mozambique,1,0,0,1,2000,False
890,53,Brazil,0,6,6,12,2000,False
891,54,Jamaica,0,6,3,9,2000,False
892,55,Belgium,0,2,3,5,2000,False
893,55,South Africa,0,2,3,5,2000,False
894,57,Argentina,0,2,2,4,2000,False
895,58,Chinese Taipei,0,1,4,5,2000,False
896,58,Morocco,0,1,4,5,2000,False
897,60,North Korea,0,1,3,4,2000,False
898,61,Moldova,0,1,1,2,2000,False
899,61,Saudi Arabia,0,1,1,2,2000,False
900,61,Trinidad and Tobago,0,1,1,2,2000,False
901,64,Ireland,0,1,0,1,2000,False
902,64,Sri Lanka,0,1,0,1,2000,False
903,64,Uruguay,0,1,0,1,2000,False
904,64,Vietnam,0,1,0,1,2000,False
905,68,Georgia,0,0,6,6,2000,False
906,69,Costa Rica,0,0,2,2,2000,False
907,69,Portugal,0,0,2,2,2000,False
908,71,Armenia,0,0,1,1,2000,False
909,71,Barbados,0,0,1,1,2000,False
910,71,Chile,0,0,1,1,2000,False
911,71,Iceland,0,0,1,1,2000,False
912,71,India,0,0,1,1,2000,False
913,71,Israel,0,0,1,1,2000,False
914,71,Kuwait,0,0,1,1,2000,False
915,71,Kyrgyzstan,0,0,1,1,2000,False
916,71,Macedonia,0,0,1,1,2000,False
917,71,Qatar,0,0,1,1,2000,False
918,1,United States,36,39,26,101,2004,False
919,2,China,32,17,14,63,2004,False
920,3,Russia,28,26,36,90,2004,False
921,4,Australia,17,16,17,50,2004,False
922,5,Japan,16,9,12,37,2004,False
923,6,Germany,13,16,20,49,2004,False
924,7,France,11,9,13,33,2004,False
925,8,Italy,10,11,11,32,2004,False
926,9,South Korea,9,12,9,30,2004,False
927,10,Great Britain,9,9,12,30,2004,False
928,11,Cuba,9,7,11,27,2004,False
929,12,Hungary,8,6,3,17,2004,False
930,13,Ukraine,8,5,9,22,2004,False
931,14,Romania,8,5,6,19,2004,False
932,15,Greece,6,6,4,16,2004,True
933,16,Brazil,5,2,3,10,2004,False
934,17,Norway,5,0,1,6,2004,False
935,18,Netherlands,4,9,9,22,2004,False
936,19,Sweden,4,2,1,7,2004,False
937,20,Spain,3,11,6,20,2004,False
938,21,Canada,3,6,3,12,2004,False
939,22,Turkey,3,3,4,10,2004,False
940,23,Poland,3,2,5,10,2004,False
941,24,New Zealand,3,2,0,5,2004,False
942,25,Thailand,3,1,4,8,2004,False
943,26,Belarus,2,5,6,13,2004,False
944,27,Austria,2,4,1,7,2004,False
945,28,Ethiopia,2,3,2,7,2004,False
946,29,Iran,2,2,2,6,2004,False
947,29,Slovakia,2,2,2,6,2004,False
948,31,Chinese Taipei,2,2,1,5,2004,False
949,32,Georgia,2,2,0,4,2004,False
950,33,Bulgaria,2,1,9,12,2004,False
951,34,Denmark,2,1,5,8,2004,False
952,35,Jamaica,2,1,2,5,2004,False
953,35,Uzbekistan,2,1,2,5,2004,False
954,37,Morocco,2,1,0,3,2004,False
955,38,Argentina,2,0,4,6,2004,False
956,39,Chile,2,0,1,3,2004,False
957,40,Kazakhstan,1,4,3,8,2004,False
958,41,Kenya,1,4,2,7,2004,False
959,42,Czech Republic,1,3,5,9,2004,False
960,43,South Africa,1,3,2,6,2004,False
961,44,Croatia,1,2,2,5,2004,False
962,45,Lithuania,1,2,0,3,2004,False
963,46,Egypt,1,1,3,5,2004,False
964,46,Switzerland,1,1,3,5,2004,False
965,48,Indonesia,1,1,2,4,2004,False
966,49,Zimbabwe,1,1,1,3,2004,False
967,50,Azerbaijan,1,0,4,5,2004,False
968,51,Belgium,1,0,2,3,2004,False
969,52,Bahamas,1,0,1,2,2004,False
970,52,Israel,1,0,1,2,2004,False
971,54,Cameroon,1,0,0,1,2004,False
972,54,Dominican Republic,1,0,0,1,2004,False
973,54,United Arab Emirates,1,0,0,1,2004,False
974,57,North Korea,0,4,1,5,2004,False
975,58,Latvia,0,4,0,4,2004,False
976,59,Mexico,0,3,1,4,2004,False
977,60,Portugal,0,2,1,3,2004,False
978,61,Finland,0,2,0,2,2004,False
979,61,Serbia and Montenegro,0,2,0,2,2004,False
980,63,Slovenia,0,1,3,4,2004,False
981,64,Estonia,0,1,2,3,2004,False
982,65,Hong Kong,0,1,0,1,2004,False
983,65,India,0,1,0,1,2004,False
984,65,Paraguay,0,1,0,1,2004,False
985,68,Colombia,0,0,2,2,2004,False
986,68,Nigeria,0,0,2,2,2004,False
987,68,Venezuela,0,0,2,2,2004,False
988,71,Eritrea,0,0,1,1,2004,False
989,71,Mongolia,0,0,1,1,2004,False
990,71,Syria,0,0,1,1,2004,False
991,71,Trinidad and Tobago,0,0,1,1,2004,False
992,1,China,48,22,30,100,2008,True
993,2,United States,36,39,37,112,2008,False
994,3,Russia,24,13,23,60,2008,False
995,4,Great Britain,19,13,19,51,2008,False
996,5,Germany,16,11,14,41,2008,False
997,6,Australia,14,15,17,46,2008,False
998,7,South Korea,13,11,8,32,2008,False
999,8,Japan,9,8,8,25,2008,False
1000,9,Italy,8,9,10,27,2008,False
1001,10,France,7,16,20,43,2008,False
1002,11,Netherlands,7,5,4,16,2008,False
1003,12,Ukraine,7,4,11,22,2008,False
1004,13,Kenya,6,4,6,16,2008,False
1005,14,Spain,5,11,3,19,2008,False
1006,15,Jamaica,5,4,2,11,2008,False
1007,16,Poland,4,5,2,11,2008,False
1008,17,Ethiopia,4,2,1,7,2008,False
1009,18,Romania,4,1,4,9,2008,False
1010,19,Cuba,3,10,17,30,2008,False
1011,20,Canada,3,9,8,20,2008,False
1012,21,Hungary,3,5,2,10,2008,False
1013,22,Norway,3,5,1,9,2008,False
1014,23,Brazil,3,4,10,17,2008,False
1015,24,Belarus,3,4,7,14,2008,False
1016,25,Czech Republic,3,3,1,7,2008,False
1017,26,Slovakia,3,3,0,6,2008,False
1018,27,New Zealand,3,2,4,9,2008,False
1019,28,Georgia,3,2,2,7,2008,False
1020,29,Kazakhstan,2,3,4,9,2008,False
1021,30,Denmark,2,2,3,7,2008,False
1022,31,North Korea,2,2,2,6,2008,False
1023,31,Thailand,2,2,2,6,2008,False
1024,33,Mongolia,2,2,0,4,2008,False
1025,34,Switzerland,2,1,4,7,2008,False
1026,35,Argentina,2,0,4,6,2008,False
1027,36,Mexico,2,0,2,4,2008,False
1028,37,Belgium,2,0,0,2,2008,False
1029,38,Zimbabwe,1,3,0,4,2008,False
1030,39,Slovenia,1,2,2,5,2008,False
1031,40,Azerbaijan,1,1,4,6,2008,False
1032,40,Indonesia,1,1,4,6,2008,False
1033,42,Bulgaria,1,1,3,5,2008,False
1034,42,Turkey,1,1,3,5,2008,False
1035,44,Chinese Taipei,1,1,2,4,2008,False
1036,44,Finland,1,1,2,4,2008,False
1037,46,Latvia,1,1,1,3,2008,False
1038,47,Dominican Republic,1,1,0,2,2008,False
1039,47,Estonia,1,1,0,2,2008,False
1040,47,Portugal,1,1,0,2,2008,False
1041,47,Trinidad and Tobago,1,1,0,2,2008,False
1042,51,India,1,0,2,3,2008,False
1043,52,Iran,1,0,1,2,2008,False
1044,53,Cameroon,1,0,0,1,2008,False
1045,53,Panama,1,0,0,1,2008,False
1046,53,Tunisia,1,0,0,1,2008,False
1047,56,Sweden,0,4,1,5,2008,False
1048,57,Lithuania,0,3,2,5,2008,False
1049,57,Nigeria,0,3,2,5,2008,False
1050,59,Croatia,0,2,3,5,2008,False
1051,60,Colombia,0,2,1,3,2008,False
1052,60,Greece,0,2,1,3,2008,False
1053,62,Armenia,0,1,4,5,2008,False
1054,63,Uzbekistan,0,1,3,4,2008,False
1055,64,Austria,0,1,2,3,2008,False
1056,64,Ireland,0,1,2,3,2008,False
1057,64,Kyrgyzstan,0,1,2,3,2008,False
1058,64,Serbia,0,1,2,3,2008,False
1059,68,Algeria,0,1,1,2,2008,False
1060,68,Bahamas,0,1,1,2,2008,False
1061,68,Morocco,0,1,1,2,2008,False
1062,68,Tajikistan,0,1,1,2,2008,False
1063,72,Chile,0,1,0,1,2008,False
1064,72,Ecuador,0,1,0,1,2008,False
1065,72,Iceland,0,1,0,1,2008,False
1066,72,Malaysia,0,1,0,1,2008,False
1067,72,Samoa,0,1,0,1,2008,False
1068,72,Singapore,0,1,0,1,2008,False
1069,72,South Africa,0,1,0,1,2008,False
1070,72,Sudan,0,1,0,1,2008,False
1071,72,Vietnam,0,1,0,1,2008,False
1072,81,Egypt,0,0,2,2,2008,False
1073,82,Afghanistan,0,0,1,1,2008,False
1074,82,Israel,0,0,1,1,2008,False
1075,82,Mauritius,0,0,1,1,2008,False
1076,82,Moldova,0,0,1,1,2008,False
1077,82,Togo,0,0,1,1,2008,False
1078,82,Venezuela,0,0,1,1,2008,False
1079,1,United States,48,26,30,104,2012,False
1080,2,China,39,31,22,92,2012,False
1081,3,Great Britain,29,18,18,65,2012,True
1082,4,Russia,18,21,26,65,2012,False
1083,5,South Korea,13,9,9,31,2012,False
1084,6,Germany,11,20,13,44,2012,False
1085,7,France,11,11,13,35,2012,False
1086,8,Australia,8,15,12,35,2012,False
1087,9,Italy,8,9,11,28,2012,False
1088,10,Hungary,8,4,6,18,2012,False
1089,11,Japan,7,14,17,38,2012,False
1090,12,Iran,7,5,1,13,2012,False
1091,13,Netherlands,6,6,8,20,2012,False
1092,14,New Zealand,6,2,5,13,2012,False
1093,15,Ukraine,5,4,10,19,2012,False
1094,16,Cuba,5,3,7,15,2012,False
1095,17,Spain,4,10,6,20,2012,False
1096,18,Jamaica,4,5,4,13,2012,False
1097,19,Czech Republic,4,4,3,11,2012,False
1098,20,South Africa,4,1,1,6,2012,False
1099,21,North Korea,4,0,2,6,2012,False
1100,22,Brazil,3,5,9,17,2012,False
1101,23,Kazakhstan,3,2,6,11,2012,False
1102,23,Poland,3,2,6,11,2012,False
1103,25,Ethiopia,3,2,3,8,2012,False
1104,26,Croatia,3,1,2,6,2012,False
1105,27,Canada,2,6,10,18,2012,False
1106,28,Belarus,2,5,3,10,2012,False
1107,29,Kenya,2,4,7,13,2012,False
1108,30,Denmark,2,4,3,9,2012,False
1109,31,Romania,2,4,1,7,2012,False
1110,32,Azerbaijan,2,2,5,9,2012,False
1111,33,Switzerland,2,2,0,4,2012,False
1112,34,Norway,2,1,1,4,2012,False
1113,35,Lithuania,2,0,3,5,2012,False
1114,36,Tunisia,2,0,1,3,2012,False
1115,37,Sweden,1,4,3,8,2012,False
1116,38,Colombia,1,3,5,9,2012,False
1117,39,Mexico,1,3,4,8,2012,False
1118,40,Georgia,1,2,3,6,2012,False
1119,41,Ireland,1,1,4,6,2012,False
1120,42,Argentina,1,1,2,4,2012,False
1121,42,Serbia,1,1,2,4,2012,False
1122,42,Slovenia,1,1,2,4,2012,False
1123,42,Trinidad and Tobago,1,1,2,4,2012,False
1124,46,Turkey,1,1,1,3,2012,False
1125,47,Dominican Republic,1,1,0,2,2012,False
1126,48,Chinese Taipei,1,0,1,2,2012,False
1127,48,Latvia,1,0,1,2,2012,False
1128,50,Algeria,1,0,0,1,2012,False
1129,50,Bahamas,1,0,0,1,2012,False
1130,50,Bahrain,1,0,0,1,2012,False
1131,50,Grenada,1,0,0,1,2012,False
1132,50,Uganda,1,0,0,1,2012,False
1133,50,Venezuela,1,0,0,1,2012,False
1134,56,Egypt,0,3,1,4,2012,False
1135,57,India,0,2,4,6,2012,False
1136,58,Mongolia,0,2,3,5,2012,False
1137,59,Thailand,0,2,2,4,2012,False
1138,60,Bulgaria,0,2,1,3,2012,False
1139,60,Finland,0,2,1,3,2012,False
1140,60,Indonesia,0,2,1,3,2012,False
1141,63,Slovakia,0,1,3,4,2012,False
1142,64,Belgium,0,1,2,3,2012,False
1143,65,Armenia,0,1,1,2,2012,False
1144,65,Estonia,0,1,1,2,2012,False
1145,65,Malaysia,0,1,1,2,2012,False
1146,65,Puerto Rico,0,1,1,2,2012,False
1147,65,Qatar,0,1,1,2,2012,False
1148,70,Botswana,0,1,0,1,2012,False
1149,70,Cyprus,0,1,0,1,2012,False
1150,70,Gabon,0,1,0,1,2012,False
1151,70,Guatemala,0,1,0,1,2012,False
1152,70,Montenegro,0,1,0,1,2012,False
1153,70,Portugal,0,1,0,1,2012,False
1154,76,Uzbekistan,0,0,3,3,2012,False
1155,77,Greece,0,0,2,2,2012,False
1156,77,Singapore,0,0,2,2,2012,False
1157,79,Afghanistan,0,0,1,1,2012,False
1158,79,Cameroon,0,0,1,1,2012,False
1159,79,Hong Kong,0,0,1,1,2012,False
1160,79,Kuwait,0,0,1,1,2012,False
1161,79,Morocco,0,0,1,1,2012,False
1162,79,Saudi Arabia,0,0,1,1,2012,False
1163,79,Tajikistan,0,0,1,1,2012,False
1164,79,Vietnam,0,0,1,1,2012,False
1165,1,United States,46,37,38,121,2016,False
1166,2,Great Britain,27,23,17,67,2016,False
1167,3,China,26,18,26,70,2016,False
1168,4,Russia,19,17,20,56,2016,False
1169,5,Germany,17,10,15,42,2016,False
1170,6,Japan,12,8,21,41,2016,False
1171,7,France,10,18,14,42,2016,False
1172,8,South Korea,9,3,9,21,2016,False
1173,9,Italy,8,12,8,28,2016,False
1174,10,Australia,8,11,10,29,2016,False
1175,11,Netherlands,8,7,4,19,2016,False
1176,12,Hungary,8,3,4,15,2016,False
1177,13,Brazil,7,6,6,19,2016,True
1178,14,Spain,7,4,6,17,2016,False
1179,15,Kenya,6,6,1,13,2016,False
1180,16,Jamaica,6,3,2,11,2016,False
1181,17,Croatia,5,3,2,10,2016,False
1182,18,Cuba,5,2,4,11,2016,False
1183,19,New Zealand,4,9,5,18,2016,False
1184,20,Canada,4,3,15,22,2016,False
1185,21,Uzbekistan,4,2,7,13,2016,False
1186,22,Colombia,3,2,3,8,2016,False
1187,23,Switzerland,3,2,2,7,2016,False
1188,24,Iran,3,1,4,8,2016,False
1189,25,Greece,3,1,2,6,2016,False
1190,26,Argentina,3,1,0,4,2016,False
1191,27,Denmark,2,6,7,15,2016,False
1192,28,Sweden,2,6,3,11,2016,False
1193,29,South Africa,2,6,2,10,2016,False
1194,30,Kazakhstan,2,5,10,17,2016,False
1195,31,Ukraine,2,5,4,11,2016,False
1196,32,Serbia,2,4,2,8,2016,False
1197,33,Poland,2,3,6,11,2016,False
1198,34,North Korea,2,3,2,7,2016,False
1199,35,Belgium,2,2,2,6,2016,False
1200,35,Thailand,2,2,2,6,2016,False
1201,37,Slovakia,2,2,0,4,2016,False
1202,38,Georgia,2,1,4,7,2016,False
1203,39,Azerbaijan,1,7,10,18,2016,False
1204,40,Belarus,1,4,4,9,2016,False
1205,41,Turkey,1,3,4,8,2016,False
1206,42,Armenia,1,3,0,4,2016,False
1207,43,Czech Republic,1,2,7,10,2016,False
1208,44,Ethiopia,1,2,5,8,2016,False
1209,45,Slovenia,1,2,1,4,2016,False
1210,46,Indonesia,1,2,0,3,2016,False
1211,47,Romania,1,1,2,4,2016,False
1212,48,Bahrain,1,1,0,2,2016,False
1213,48,Vietnam,1,1,0,2,2016,False
1214,50,Chinese Taipei,1,0,2,3,2016,False
1215,51,Bahamas,1,0,1,2,2016,False
1216,51,Independent Olympic Athletes,1,0,1,2,2016,False
1217,51,Ivory Coast,1,0,1,2,2016,False
1218,54,Fiji,1,0,0,1,2016,False
1219,54,Jordan,1,0,0,1,2016,False
1220,54,Kosovo,1,0,0,1,2016,False
1221,54,Puerto Rico,1,0,0,1,2016,False
1222,54,Singapore,1,0,0,1,2016,False
1223,54,Tajikistan,1,0,0,1,2016,False
1224,60,Malaysia,0,4,1,5,2016,False
1225,61,Mexico,0,3,2,5,2016,False
1226,62,Venezuela,0,2,1,3,2016,False
1227,63,Algeria,0,2,0,2,2016,False
1228,63,Ireland,0,2,0,2,2016,False
1229,65,Lithuania,0,1,3,4,2016,False
1230,66,Bulgaria,0,1,2,3,2016,False
1231,67,India,0,1,1,2,2016,False
1232,67,Mongolia,0,1,1,2,2016,False
1233,69,Burundi,0,1,0,1,2016,False
1234,69,Grenada,0,1,0,1,2016,False
1235,69,Niger,0,1,0,1,2016,False
1236,69,Philippines,0,1,0,1,2016,False
1237,69,Qatar,0,1,0,1,2016,False
1238,74,Norway,0,0,4,4,2016,False
1239,75,Egypt,0,0,3,3,2016,False
1240,75,Tunisia,0,0,3,3,2016,False
1241,77,Israel,0,0,2,2,2016,False
1242,78,Austria,0,0,1,1,2016,False
1243,78,Dominican Republic,0,0,1,1,2016,False
1244,78,Estonia,0,0,1,1,2016,False
1245,78,Finland,0,0,1,1,2016,False
1246,78,Morocco,0,0,1,1,2016,False
1247,78,Nigeria,0,0,1,1,2016,False
1248,78,Portugal,0,0,1,1,2016,False
1249,78,Trinidad and Tobago,0,0,1,1,2016,False
1250,78,United Arab Emirates,0,0,1,1,2016,False
1251,1,United States,39,41,33,113,2020,False
1252,2,China,38,32,19,89,2020,False
1253,3,Japan,27,14,17,58,2020,True
1254,4,Great Britain,22,20,22,64,2020,False
1255,5,ROC,20,28,23,71,2020,False
1256,6,Australia,17,7,22,46,2020,False
1257,7,Netherlands,10,12,14,36,2020,False
1258,8,France,10,12,11,33,2020,False
1259,9,Germany,10,11,16,37,2020,False
1260,10,Italy,10,10,20,40,2020,False
1261,11,Canada,7,7,10,24,2020,False
1262,12,Brazil,7,6,8,21,2020,False
1263,13,New Zealand,7,6,7,20,2020,False
1264,14,Cuba,7,3,5,15,2020,False
1265,15,Hungary,6,7,7,20,2020,False
1266,16,South Korea,6,4,10,20,2020,False
1267,17,Poland,4,5,5,14,2020,False
1268,18,Czech Republic,4,4,3,11,2020,False
1269,19,Kenya,4,4,2,10,2020,False
1270,20,Norway,4,2,2,8,2020,False
1271,21,Jamaica,4,1,4,9,2020,False
1272,22,Spain,3,8,6,17,2020,False
1273,23,Sweden,3,6,0,9,2020,False
1274,24,Switzerland,3,4,6,13,2020,False
1275,25,Denmark,3,4,4,11,2020,False
1276,26,Croatia,3,3,2,8,2020,False
1277,27,Iran,3,2,2,7,2020,False
1278,28,Serbia,3,1,5,9,2020,False
1279,29,Belgium,3,1,3,7,2020,False
1280,30,Bulgaria,3,1,2,6,2020,False
1281,31,Slovenia,3,1,1,5,2020,False
1282,32,Uzbekistan,3,0,2,5,2020,False
1283,33,Georgia,2,5,1,8,2020,False
1284,34,Chinese Taipei,2,4,6,12,2020,False
1285,35,Turkey,2,2,9,13,2020,False
1286,36,Greece,2,1,1,4,2020,False
1287,36,Uganda,2,1,1,4,2020,False
1288,38,Ecuador,2,1,0,3,2020,False
1289,39,Ireland,2,0,2,4,2020,False
1290,39,Israel,2,0,2,4,2020,False
1291,41,Qatar,2,0,1,3,2020,False
1292,42,Bahamas,2,0,0,2,2020,False
1293,42,Kosovo,2,0,0,2,2020,False
1294,44,Ukraine,1,6,12,19,2020,False
1295,45,Belarus,1,3,3,7,2020,False
1296,46,Romania,1,3,0,4,2020,False
1297,46,Venezuela,1,3,0,4,2020,False
1298,48,India,1,2,4,7,2020,False
1299,49,Hong Kong,1,2,3,6,2020,False
1300,50,Philippines,1,2,1,4,2020,False
1301,50,Slovakia,1,2,1,4,2020,False
1302,52,South Africa,1,2,0,3,2020,False
1303,53,Austria,1,1,5,7,2020,False
1304,54,Egypt,1,1,4,6,2020,False
1305,55,Indonesia,1,1,3,5,2020,False
1306,56,Ethiopia,1,1,2,4,2020,False
1307,56,Portugal,1,1,2,4,2020,False
1308,58,Tunisia,1,1,0,2,2020,False
1309,59,Estonia,1,0,1,2,2020,False
1310,59,Fiji,1,0,1,2,2020,False
1311,59,Latvia,1,0,1,2,2020,False
1312,59,Thailand,1,0,1,2,2020,False
1313,63,Bermuda,1,0,0,1,2020,False
1314,63,Morocco,1,0,0,1,2020,False
1315,63,Puerto Rico,1,0,0,1,2020,False
1316,66,Colombia,0,4,1,5,2020,False
1317,67,Azerbaijan,0,3,4,7,2020,False
1318,68,Dominican Republic,0,3,2,5,2020,False
1319,69,Armenia,0,2,2,4,2020,False
1320,70,Kyrgyzstan,0,2,1,3,2020,False
1321,71,Mongolia,0,1,3,4,2020,False
1322,72,Argentina,0,1,2,3,2020,False
1323,72,San Marino,0,1,2,3,2020,False
1324,74,Jordan,0,1,1,2,2020,False
1325,74,Malaysia,0,1,1,2,2020,False
1326,74,Nigeria,0,1,1,2,2020,False
1327,77,Bahrain,0,1,0,1,2020,False
1328,77,Lithuania,0,1,0,1,2020,False
1329,77,Namibia,0,1,0,1,2020,False
1330,77,North Macedonia,0,1,0,1,2020,False
1331,77,Saudi Arabia,0,1,0,1,2020,False
1332,77,Turkmenistan,0,1,0,1,2020,False
1333,83,Kazakhstan,0,0,8,8,2020,False
1334,84,Mexico,0,0,4,4,2020,False
1335,85,Finland,0,0,2,2,2020,False
1336,86,Botswana,0,0,1,1,2020,False
1337,86,Burkina Faso,0,0,1,1,2020,False
1338,86,Ghana,0,0,1,1,2020,False
1339,86,Grenada,0,0,1,1,2020,False
1340,86,Ivory Coast,0,0,1,1,2020,False
1341,86,Kuwait,0,0,1,1,2020,False
1342,86,Moldova,0,0,1,1,2020,False
1343,86,Syria,0,0,1,1,2020,False
1344,1,United States,40,44,42,126,2024,False
1345,2,China,40,27,24,91,2024,False
1346,3,Japan,20,12,13,45,2024,False
1347,4,Australia,18,19,16,53,2024,False
1348,5,France,16,26,22,64,2024,True
1349,6,Netherlands,15,7,12,34,2024,False
1350,7,Great Britain,14,22,29,65,2024,False
1351,8,South Korea,13,9,10,32,2024,False
1352,9,Italy,12,13,15,40,2024,False
1353,10,Germany,12,13,8,33,2024,False
1354,11,New Zealand,10,7,3,20,2024,False
1355,12,Canada,9,7,11,27,2024,False
1356,13,Uzbekistan,8,2,3,13,2024,False
1357,14,Hungary,6,7,6,19,2024,False
1358,15,Spain,5,4,9,18,2024,False
1359,16,Sweden,4,4,3,11,2024,False
1360,17,Kenya,4,2,5,11,2024,False
1361,18,Norway,4,1,3,8,2024,False
1362,19,Ireland,4,0,3,7,2024,False
1363,20,Brazil,3,7,10,20,2024,False
1364,21,Iran,3,6,3,12,2024,False
1365,22,Ukraine,3,5,4,12,2024,False
1366,23,Romania,3,4,2,9,2024,False
1367,24,Georgia,3,3,1,7,2024,False
1368,25,Belgium,3,1,6,10,2024,False
1369,26,Bulgaria,3,1,3,7,2024,False
1370,27,Serbia,3,1,1,5,2024,False
1371,28,Czech Republic,3,0,2,5,2024,False
1372,29,Denmark,2,2,5,9,2024,False
1373,30,Azerbaijan,2,2,3,7,2024,False
1374,30,Croatia,2,2,3,7,2024,False
1375,32,Cuba,2,1,6,9,2024,False
1376,33,Bahrain,2,1,1,4,2024,False
1377,34,Slovenia,2,1,0,3,2024,False
1378,35,Chinese Taipei,2,0,5,7,2024,False
1379,36,Austria,2,0,3,5,2024,False
1380,37,Hong Kong,2,0,2,4,2024,False
1381,37,Philippines,2,0,2,4,2024,False
1382,39,Algeria,2,0,1,3,2024,False
1383,39,Indonesia,2,0,1,3,2024,False
1384,41,Israel,1,5,1,7,2024,False
1385,42,Poland,1,4,5,10,2024,False
1386,43,Kazakhstan,1,3,3,7,2024,False
1387,44,Jamaica,1,3,2,6,2024,False
1388,44,South Africa,1,3,2,6,2024,False
1389,44,Thailand,1,3,2,6,2024,False
1390,47,Ethiopia,1,3,0,4,2024,False
1391,48,Switzerland,1,2,5,8,2024,False
1392,49,Ecuador,1,2,2,5,2024,False
1393,50,Portugal,1,2,1,4,2024,False
1394,51,Greece,1,1,6,8,2024,False
1395,52,Argentina,1,1,1,3,2024,False
1396,52,Egypt,1,1,1,3,2024,False
1397,52,Tunisia,1,1,1,3,2024,False
1398,55,Botswana,1,1,0,2,2024,False
1399,55,Chile,1,1,0,2,2024,False
1400,55,Saint Lucia,1,1,0,2,2024,False
1401,55,Uganda,1,1,0,2,2024,False
1402,59,Dominican Republic,1,0,2,3,2024,False
1403,60,Guatemala,1,0,1,2,2024,False
1404,60,Morocco,1,0,1,2,2024,False
1405,62,Dominica,1,0,0,1,2024,False
1406,62,Pakistan,1,0,0,1,2024,False
1407,64,Turkey,0,3,5,8,2024,False
1408,65,Mexico,0,3,2,5,2024,False
1409,66,Armenia,0,3,1,4,2024,False
1410,66,Colombia,0,3,1,4,2024,False
1411,68,Kyrgyzstan,0,2,4,6,2024,False
1412,68,North Korea,0,2,4,6,2024,False
1413,70,Lithuania,0,2,2,4,2024,False
1414,71,India,0,1,5,6,2024,False
1415,72,Moldova,0,1,3,4,2024,False
1416,73,Kosovo,0,1,1,2,2024,False
1417,74,Cyprus,0,1,0,1,2024,False
1418,74,Fiji,0,1,0,1,2024,False
1419,74,Jordan,0,1,0,1,2024,False
1420,74,Mongolia,0,1,0,1,2024,False
1421,74,Panama,0,1,0,1,2024,False
1422,79,Tajikistan,0,0,3,3,2024,False
1423,80,Albania,0,0,2,2,2024,False
1424,80,Grenada,0,0,2,2,2024,False
1425,80,Malaysia,0,0,2,2,2024,False
1426,80,Puerto Rico,0,0,2,2,2024,False
1427,84,Cabo Verde,0,0,1,1,2024,False
1428,84,Ivory Coast,0,0,1,1,2024,False
1429,84,Peru,0,0,1,1,2024,False
1430,84,Qatar,0,0,1,1,2024,False
1431,84,Refugee Olympic Team,0,0,1,1,2024,False
1432,84,Singapore,0,0,1,1,2024,False
1433,84,Slovakia,0,0,1,1,2024,False
1434,84,Zambia,0,0,1,1,2024,False
